11111111111111
12000000000001
10000000000001
10000000000001
10000000000001
10000010000001
10000000000001
10000000000001
10000000000001
10000000000001
10000000000031
11111111111111